1111111111
*********1
11111111*1
11111111*1
11111111*1
11111111*1
11111111*1
11111111*1
11111111*1
11111111*1
