1*11111111
1*11111111
1*11111111
1*11111111
1*11111111
1*11111111
1*11111111
1*11111111
1*********
1111111111
